# # # # # # # # # # # # # # # # # # # # # # # # #
# . . . . . . . # . . . . . . . # . . . . . . . #
# . G . . . . . # . . . . . . . # . . . . . . . #
# . . . . . . . # . . . . . . . # . . . . . . . #
# . . . . . . . . . . . . . . . . . . . . . . . #
# . . . . . . . # . . . . . . . # . . . . . . . #
# . . . . . . . # . . . . . . . # . . . . . . . #
# . . . . . . . # . . . . . . . # . . . . . . . #
# # # # . # # # # # # # . # # # # # # # . # # # #
# . . . . . . . # . . . . . . . # . . . . . . . #
# . . . . . . . # . . . . . . . # . . . . . . . #
# . . . . . . . # . . . . . . . # . . . . . . . #
# . . . . . . . . . . . . . . . . . . . . . . . #
# . . . . . . . # . . . . . . . # . . . . . . . #
# . . . . . . . # . . . . . . . # . . . . . . . #
# . . . . . . . # . . . . . . . # . . . . . . . #
# # # # . # # # # # # # . # # # # # # # . # # # #
# . . . . . . . # . . . . . . . # . . . . . . . #
# . . . . . . . # . . . . . . . # . . . . . . . #
# . . . . . . . # . . . . . . . # . . . . . . . #
# . . . . . . . . . . . . . . . . . . . . . . . #
# . . . . . . . # . . . . . . . # . . . . . . . #
# . . . . . . . # . . . . . . . # . . . . . S . #
# . . . . . . . # . . . . . . . # . . . . . . . #
# # # # # # # # # # # # # # # # # # # # # # # # #