# # # # # # # # # # # # # # # # # # # # # # # # #
# . . . . . . . # . . . . . . . # . . . . . . . #
# . . . . . . . # . . . . . . . # . . . . . G . #
# . . . . . . . # . . . . . . . # . . . . . . . #
# . . . . . . . . . . . . . . . . . . . . . . . #
# . . . . . . . # . . . . . . . # . . . . . . . #
# . . . . . . . # . . . . . . . # . . . . . . . #
# . . . . . . . # . . . . . . . # . . . . . . . #
# # # # . # # # # # # # . # # # # # # # . # # # #
# . . . . . . . # . . . . . . . # . . . . . . . #
# . . . . . . . # . . . . . . . # . . . . . . . #
# . . . . . . . # . . . . . . . # . . . . . . . #
# . . . . . . . . . . . . . . . . . . . . . . . #
# . . . . . . . # . . . . . . . # . . . . . . . #
# . . . . . . . # . . . . . . . # . . . . . . . #
# . . . . . . . # . . . . . . . # . . . . . . . #
# # # # . # # # # # # # . # # # # # # # . # # # #
# . . . . . . . # . . . . . . . # . . . . . . . #
# . . . . . . . # . . . . . . . # . . . . . . . #
# . . . . . . . # . . . . . . . # . . . . . . . #
# . . . . . . . . . . . . . . . . . . . . . . . #
# . . . . . . . # . . . . . . . # . . . . . . . #
# . S . . . . . # . . . . . . . # . . . . . . . #
# . . . . . . . # . . . . . . . # . . . . . . . #
# # # # # # # # # # # # # # # # # # # # # # # # #