# # # # # # # # # # # # # # # # # # # # # # # # # # # # # # #
# . . . . . . . . . . . . . # . . . # . . . . # . . . . . . #
# . . . . . . . . . . . . . # . . . # . . . . # . . . # G . #
# . . . . . . . . . . . . . # . . . . . . . . # . . . # . . #
# . . . . . . . . . . . . . # . . . # . . . . # . . . . . . #
# . . . . . . . . . . . . . # . . . # . . . . # . . . # . . #
# . . . . . . . . . . . . . # . . . . . . . . # . . . # . . #
# . . . . . . . . . . . . . # . . . # . . . . . . . . # . . #
# . . . . . . . . . . . . . # # # # # . . . . # # . # # . . #
# . . . . . . . . . . . . . # . . . # . . . . # . . . # . . #
# . . . . . . . . . . . . . # . . . # . . . . # . . . # . . #
# . . . . . . . . . . . . . # . . . # . . . . # . . . . . . #
# . . . . . . . . . . . . . # . . . # . . . . # . . . # . . #
# . . . . . . . . . . . . . # . . . # . . . . # . . . # . . #
# . . . . . . . . . . . . . . . . . # . . . . # . . . . . . #
# . . . . . . . . . . . . . # . . . # # # # # # . . . # . . #
# # # # # # # # # # # # # # # # . # # . . . . # # . # # . . #
# . . . . . . . . . . . . . # . . . # . . . . # . . . # . . #
# . . . . . . . . . . . . . . . . . # . . . . # . . . # . . #
# . . . . . . . . . . . . . # . . . # . . . . # . . . # . . #
# # # . # # # # # # # # # . # # # # # . . . . # . . . . . . #
# . . . . # . . . . . . . . . . # . . . . . . # . . . # . . #
# . . . . # . . . . . . . . . . # # # # . # # # . . . # . . #
# . . . . # . . . . . . . . . . # . . . . . . # # . # # . . #
# . . . . . . . . . . . . . . . . . . . . . . # . . . # . . #
# . S . . # . . . . . . . . . . # . . . . . . . . . . . . . #
# . . . . # . . . . . . . . . . # . . . . . . # . . . # . . #
# # # # # # # # # # # # # # # # # # # # # # # # # # # # # # #
