# # # # # # # # # # # # #
# . . . . . . # . . . . #
# . G . . . . # . . . . #
# . . . . . . . . . . . #
# . . . . . . # . . . . #
# . . . . . . # . . . . #
# # # . # # # # # # . # #
# . . . . . # . . . . . #
# . . . . . # . . . . . #
# . . . . . . . . . . . #
# . . . . . # . . . S . #
# . . . . . # . . . . . #
# # # # # # # # # # # # #