# # # # # # # # # # # # #
# . . . . . . # . . . . #
# . . . . . . # . . S . #
# . . . . . . . . . . . #
# . . . . . . # . . . . #
# . . . . . . # . . . . #
# # # . # # # # # # . # #
# . . . . . # . . . . . #
# . . . . . # . . . . . #
# . . . . . . . . . . . #
# . G . . . # . . . . . #
# . . . . . # . . . . . #
# # # # # # # # # # # # #