# # # # # # # # # # # # #
# . . . . . . # . . . . #
# . . . . . . # . . G . #
# . . . . . . . . . . . #
# . . . . . . # . . . . #
# . . . . . . # . . . . #
# # # . # # # # # # . # #
# . . . . . # . . . . . #
# . . . . . # . . . . . #
# . . . . . . . . . . . #
# . S . . . # . . . . . #
# . . . . . # . . . . . #
# # # # # # # # # # # # #
